{
  "width": 12,
  "height": 12,
  "tiles": [
    [1, 1, 1, 1, 1, 1, 1, 1, 1, 1, 1, 1],
    [1, 0, 0, 0, 1, 0, 0, 0, 0, 0, 0, 1],
    [1, 0, 0, 0, 2, 0, 0, 0, 0, 0, 0, 1],
    [1, 0, 0, 0, 1, 0, 0, 0, 1, 0, 0, 1],
    [1, 1, 2, 1, 1, 0, 0, 0, 1, 0, 0, 1],
    [1, 0, 0, 0, 0, 0, 3, 0, 2, 0, 0, 1],
    [1, 0, 0, 0, 0, 0, 0, 0, 1, 1, 2, 1],
    [1, 0, 3, 0, 1, 1, 1, 1, 1, 0, 0, 1],
    [1, 0, 0, 0, 1, 0, 0, 0, 0, 0, 0, 1],
    [1, 0, 0, 0, 2, 0, 0, 0, 0, 0, 0, 1],
    [1, 0, 0, 0, 1, 0, 3, 0, 0, 0, 0, 1],
    [1, 1, 1, 1, 1, 1, 1, 1, 1, 1, 1, 1]
  ],
  "tile_types": {
    "0": "floor",
    "1": "wall",
    "2": "door",
    "3": "trap"
  },
  "rooms": [
    {"name": "Starting Chamber", "x1": 1, "y1": 1, "x2": 3, "y2": 3},
    {"name": "East Passage",     "x1": 5, "y1": 1, "x2": 10,"y2": 6},
    {"name": "West Hall",        "x1": 1, "y1": 5, "x2": 3, "y2": 9},
    {"name": "Inner Sanctum",    "x1": 5, "y1": 7, "x2": 10,"y2": 10}
  ]
}
